##########
##########
####.G####
####.....#
##.BG.B..#
##.#..GB##
##..#...##
###S######
##########
##########