##########
##########
####G##G##
##.B....##
##.....G##
##...#B###
###B...###
###S######
##########
##########