####################
####################
####################
####################
####################
####################
####################
#######.....G#######
#######.GB.#########
#######..###########
########S.##########
########...B.#######
########BG...#######
########..##########
####################
####################
####################
####################
####################
####################