##########
##########
###G..####
##G#...###
##.#.#B.##
##..B..S##
##..B.####
####G.####
##########
##########
