####################
####################
####################
####################
####################
####################
#########....#######
#########B#G..######
######....##B.######
######.B..##.#######
#######G.....#######
#########G##S#######
####################
####################
####################
####################
####################
####################
####################
####################