####################
####################
####################
####################
####################
##########S#########
##########B#########
##########G#########
##########.#########
#########G....######
#########B.##B######
######.G...##G######
######O##.....######
######..##.OB.######
######G.....B.######
####################
####################
####################
####################
####################
