####################
####################
####################
####################
####################
####################
########.###########
########.S##########
########.B.G########
######.GBG#.########
######.#BG#B########
######.#..#...######
######.##...#.######
######.G..BOB.######
#########..G..######
####################
####################
####################
####################
####################