####################
####################
####################
####################
####################
####################
#####....###########
####..##.###########
####B.G.G....B.S####
####..B##.OG########
####GB..##.B########
####.B...G.G########
#####.#####.########
#####.#####.########
#####.#####.########
####################
####################
####################
####################
####################