####################
####################
####################
####################
####################
####################
#######...G#########
#######B##..########
#######G##..########
#######GOSB.########
#####.G..#B....#####
#####.##.B.###.#####
#####.GB.#..##.#####
##########...B.#####
##########.G########
####################
####################
####################
####################
####################