####################
####################
####################
####################
####################
#####........#######
#####GB##O##.#######
#####G..#..O.#######
#####..BSB.#########
#####..###.#########
##########.#########
########G....G.#####
######.GB..B##.#####
##########.....#####
####################
####################
####################
####################
####################
####################