####################
####################
####################
####################
####################
####################
##########G.########
#######SO.....######
#####.BG##O.#.######
#####.#GB..B#B######
#####..##B..#.######
#####...GG.....#####
############...#####
####################
####################
####################
####################
####################
####################
####################