####################
####################
####################
####################
####################
####################
######...###########
####....GB.#########
######.#GB.#...#####
######.#....O.B#####
######.BG#.#.SO.####
##########B.#.#.####
##########.GG...####
####################
####################
####################
####################
####################
####################
####################