####################
####################
####################
####################
####################
####################
####################
#############..#####
####.BG..###.GG#####
####.###GO..B..#####
####..##.##B..######
####.....G....######
#########.##BB######
#########...OS######
####################
####################
####################
####################
####################
####################