####################
####################
####################
####################
####################
####################
##########.....#####
########..B.G#.#####
########...#.#.#####
##########.#...#####
#########.GB..######
#########.##BB######
#########G##GS######
#########B##GB######
#####.GG...B..######
####################
####################
####################
####################
####################