####################
####################
####################
####################
####################
#####.B..G##########
#####.BB#.##########
#####.B.#.##########
#####...#.##########
#####.B.G...G.G#####
######S##.##########
#########.O.G#######
#########.##B#######
#########G...#######
####################
####################
####################
####################
####################
####################